111111111111111111111111111111
1C00000001000C1000100000FC1111
111011F1C101111010001100001111
1C10011111010F1011111011010001
10100000PEC1FC101C100000000101
100000000000000010001F000000C1
111111111111111111111111111111