111111111111111111111111111111
100000000000001000100000FC1111
100000000000001010001100001111
100000000000001011111011010001
10000000PEC000101C100000000101
1000000000000000100010000000C1
111111111111111111111111111111