111111111111
1P0C10001001
100110C01001
1000C0FE00C1
111100011111
1F0C00000011
111111111111