111111111111
1P0010001001
100010C01001
1000C00E00C1
111100011001
100C000000C1
111111111111