111111111
1P0010001
100010C01
1000E0001
111111111