111111111111
1P0010001001
100010CF1001
1000C0FE00C1
111100011001
1F0C000000C1
111111111111