111111111111
1P0010001001
100010C01001
1000C00E10C1
111111111111